7 7
#######
# # 1 #
#   ###
#######
# # 2 #
#   ###
#######